NO sprites/box1.xpm
SO sprites/box2.xpm
WE sprites/box3.xpm
EA sprites/box4.xpm

F 000,000,000
C 000,000,000
  
1111111111111111111
1000000001000000001
1000000000100000000
100000E000000000001
1000000000010000001
1000000000100000001
1111111111111111111
