NO sprites/box1.xpm
SO sprites/box2.xpm
WE sprites/box3.xpm
EA sprites/box4.xpm

F 184,113,39
C 51,198,227
1111111111111111111
1N01000001000000001
1001000000100000001
1000000000000000001
1000000000010000001
1000000000100000001
1111111111111111111
