NO sprites/cra.xpm
SO sprites/east.xpm
WE sprites/cra.xpm
EA sprites/east.xpm

F 184,113,39
C 51,198,227

 11111111111111111
1000000001000000001
1000000000100000001
100000E000000000001
1000000000010000001
1000000000100000001
 11111111111111111